311111111111111111111111111111111111111111111111111111111111111331111111111111111111111111111111111111111111111111111111111111131111111111133111111111111111111111111111111111111111111111111111111111111113311111111111111111111111111111111111111111111111111111111111111331111111111111111111111111111111111111111111111111111111111111133111111111111111111111111111111111111111111111111111111111111113311111111111111111111111111111111111111111111111111111111111111331111111111111111111111111111111111111111111111111111111111111133111111111111111111111111111111111111111111111111111111111111113311111111111111111111111111111111111111111111111111111111111111331111111111111111111111111111111111111111111111111111111111111133111111111111111111111111111111111111111111111111111111111111113311111111111111111111111111111111111111111111111111111111111111331111111111111111111111111111111111111111111111111111111111111133111111111111111111111111111111111111111111111111111111111111113311111111111111111111111111111111111111111111111111111111111111331111111111111111111111111111111111111111111111111111111111111133111111111111111111111111111111111111111111111111111111111111113311111111111111111111111111111111111111111111111111111111111111331111111111111111111111111111111111111111111111111111111111111133111111111111111111111111111111111111111111111111111111111111113
20000000000000000000000000000000000000000000000000000000000444022000000000000000000000000000000000000000000000000000000000044402
20000000000000000000000000000000000000000000000000000000044400022000000000000000000000000000000000000000000000000000000004440002
20000000000000000000000000000000000000000000000000000044440000022000000000000000000000000000000000000000000000000000004444000002
20000000000000000000000000000000000000000000000000044440000000022000000000000000000000000000000000000000000000000004444000000002
20000000000000000000000000000000000000000000000044440000000000022000000000000000000000000000000000000000000000004444000000000002
20000000000000000000000000000000000000000444444440000000000000022000000000000000000000000000000000000000044444444000000000000002
20000000000000000000000000000000000444444400000000000000000000022000000000000000000000000000000000044444440000000000000000000002
20000000000000000000000000000444444400000000000000000000000000022000000000000000000000000000044444440000000000000000000000000002
20000000000000000000000444444400000000000000000000000000000000022000000000000000000000044444440000000000000000000000000000000002
20000000000000000444444400000000000000000000000000000000000000022000000000000000044444440000000000000000000000000000000000000002
20000000000004444400000000000000000000000000000000000000000000022000000000000444440000000000000000000000000000000000000000000002
20000000004444000000000000000000000000000000000000000000000000022000000000444400000000000000000000000000000000000000000000000002
20000044444000000000000000000000000000000000000000000000000000022000004444400000000000000000000000000000000000000000000000000002
20044440000000000000000000000000000000000000000000000000000000022004444000000000000000000000000000000000000000000000000000000002
24400000000000000000000000000000000000000000000000000000000000022440000000000000000000000000000000000000000000000000000000000002
31111111111111111111111111111113311111111111111111111111111111133111111111111111111111111111111331111111111111111111111111111113
31111111111111111111111111111113311111111111111111111111111111133111111111111111111111111111111331111111111111111111111111111113
20000000000000000000000000000002200000000000000000000000000000022000000000000000000000000000000220000000000000000000000000000002
20000000000000000000000000000002200000000000000000000000000000022000000000000000000000000000000220000000000000000000000000000002
20000000000000000000000000000042200000000000000000000000000000422000000000000000000000000000004220000000000000000000000000000042
20000000000044000000000000000402200000000000440000000000000004022000000000004400000000000000040220000000000044000000000000000402
20000000000400400000000000004002200000000004004000000000000040022000000000040040000000000000400220000000000400400000000000004002
20000000004400440404040404440002200000000044004404040404044400022000000000440044040404040444000220000000004400440404040404440002
20000444000000000000000000000002200004440000000000000000000000022000044400000000000000000000000220000444000000000000000000000002
20000000004000000000000000000002200000000040000000000000000000022000000000400000000000000000000220000000004000000000000000000002
20000000000400000000000000000002200000000004000000000000000000022000000000040000000000000000000220000000000400000000000000000002
20000000000040000000000000000002200000000000400000000000000000022000000000004000000000000000000220000000000040000000000000000002
20000000000004400000000000000002200000000000044000000000000000022000000000000440000000000000000220000000000004400000000000000002
20000000000000000044000000000002200000000000000000440000000000022000000000000000004400000000000220000000000000000044000000000002
20000000000000044000000000000002200000000000000440000000000000022000000000000004400000000000000220000000000000044000000000000002
20000000000044000000000000000002200000000000440000000000000000022000000000004400000000000000000220000000000044000000000000000002
20000044440000000000000000000002200000444400000000000000000000022000004444000000000000000000000220000044440000000000000000000002
20000000000000000000000000000002200000000000000000000000000000022000000000000000000000000000000220000000000000000000000000000002
31111111111111111111111111111113311111111111111111111111111111133111111111111111111111111111111331111111111111111111111111111113
