31111111111111111111111111111111111111111111111111111111111111133111111111111111111111111111111111111111111111111111111111111113
20000000000000000000000000000000000000000000000000000000000000000000000000000000000000000000000000000000000000000000000000000002
20000000000000000000000000000000000000000000000000000000000000000000000000000000000000000000000000000000000000000000000000000002
20000000000000000000000000000000000000000000000000000444400000000000000000000000000000000000000000000000000000000000000000000002
20000000000000000000000000000000000000000000000000004404000000000000000000000000000000000000000000000000000000000000000000000002
20000000000000000004400000000000000000000000000000004444000000000000000000000000000000000000000000000000000000000000000000000002
20000000000000000004400000000000000000000000000000000000000000000000000040000000000000000000444000000000000000000000000000000002
20000000000000000000000000000000000000000000000000000000000000000000000000000000000000000000404000000000000000400000000000000002
20000000000000000000000000000000000000000000000000000000000000000000000000000000000000000000444000000000000004000000000000000002
20000000000000000000000000000000000000040000000000000000000000000040000000000000000000000000000000000000000040000000000000000002
20000000000000000000000000000000000000040000000000000000000000000040000000000000000000000000000000000000000400000000000000000002
20000000000000000000000000000000000000040000000000000000000000000000000000000000000000000000000000000000004000000000000000000002
20000000000000000000000000000000000000040000000000000000000000000000000000000000000000000000000000000000040000000000000000000002
20000000000000000000000000000000000000040000000000000000000000000000000000000000000000000000000000000000000000000000000000000002
20000000000000000000000000000000000000000000000000000000000000000000000000000000000000000000044444444440000000000000000000000002
20000000000000000000000000000000000000000000000000000000000000000000000000000000000000000000000000000000000000000000000000000002
20000000000000000000000000000000000000000000000000000000000000000000000000000000000000000000000000000000000000000000000000000002
31111111111111111111111111111111111111111111111111111111111111133111111111111111111111111111111331111111111111111111111111111113
00000000000000000000000000000000000000000000000000000000000000000000000000000000000000000000000000000000000000000000000000000000
00000000000000000000000000000000000000000000000000000000000000000000000000000000000000000000000000000000000000000000000000000000
00000000000000000000000000000000000000000000000000000000000000000000000000000000000000000000000000000000000000000000000000000000
00000000000000000000000000000000000000000000000000000000000000000000000000000000000000000000000000000000000000000000000000000000
